8784448784
7b74447b74
f7f474f7f4
4448844444
4444444f44
44f7808744
4444444444