 111111111111
11777777777711
177bbbbbbbb771
17bb777777bb71
17b74444447b71
17bb7777777711
117bbbbbbbb711
1177777777bb71
17b74444447b71
17bb777777bb71
117bbbbbbbb711
 117777777711
  1111111111